11111111111111111
10020300205023001
10101014101010101
12200200220400001
10121012101410121
14535035330250051
10101012151213121
14254422420022201
10151412121014101
10055022222020001
11111111111111111
