11111111111111111
10020053223222001
10121212141213101
15202242202432221
12121213121214101
15234002552432231
12121415131212121
12220220322322221
10101313141012101
10022222022242001
11111111111111111
