11111111111111111
10025240342222001
10101214131212101
10252202222042321
15121212121212121
13202552222222351
12121212121212121
12222505222544251
10101212101512121
14522522032222421
12101215121310121
12352223350552221
12121412101213121
12022023224223521
10121512121212101
10002225202253001
11111111111111111
